############################
#............##............#
#*####.#####.##.#####.####*#
#..........................#
#.####.##.########.##.####.#
#......##....##....##......#
######.#####.##.#####.######     
     #.##..... ....##.#     
     #.##.###--###.##.#     
######.##.#      #.##.######
      ....#      #....      
######.##.#      #.##.######
     #.##.########.##.#     
     #.##..........##.#         
######.##.########.##.######
#............##............#
#.####.#####.##.#####.####.#
#*..##........ .......##..*#
###.##.##.########.##.##.###
#......##....##....##......#
#.##########.##.##########.#
#..........................#
############################